R	1920	1080

S	../../sprites/pillar.xpm

NO	../../sprites/eagle.xpm
SO	../../sprites/colorstone.xpm
WE	../../sprites/greystone.xpm
EA	../../sprites/purplestone.xpm

F	255, 102, 103
C	151, 0, 201

11111111111
10E000000001
10000000001
10000000011
100000001
10000000111
10000000001
10000000001
11111111111
