R	800	800

S	../../sprites/pillar.xpm

NO	../../sprites/eagle.xpm
SO	../../sprites/colorstone.xpm
WE	../../sprites/greystone.xpm
EA	../../sprites/purplestone.xpm

F	255, 102, 103
C	151, 0, 201

111111111111111
100000000000001
100000000000011
100000000000011
100000000001111
10N000000001111
100000000001111
100000000000001
111111111111111
