R	1080	720

S	../../sprites/pillar.xpm

NO	../../sprites/eagle.xpm
SO	../../sprites/colorstone.xpm
WE	../../sprites/greystone.xpm
EA	../../sprites/purplestone.xpm

F	101, 102, 103
C	201, 0, 201

11111111111
100000000001
10E00000001
10000000011
100000001
10000000111
10000000001
10000000001
11111111111
