R	1920	1080

S	../../sprites/pillar.xpm

NO	../../sprites/eagle.xpm
SO	../../sprites/colorstone.xpm
WE	../../sprites/greystone.xpm
EA	../../sprites/purplestone.xpm

F	101  ,	102 , 		0	 
C	201   ,			   202	  	 ,   0 

11111111111
1002000N001
10000000001
11111111111
