R	800 800

NO	srcs/sprites/mossy.xpm
SO	srcs/sprites/colorstone.xpm


WE	srcs/sprites/greystone.xpm
EA	srcs/sprites/redbrick.xpm
S	srcs/sprites/zombiehand.xpm

F	65, 43, 40
C	151, 0, 201


 
111111111111111     1111
100000000000001     1001
100000000000011     1111
100000000000011
10000000N000001
100020000020001
111111111111111
 
111111111
100000001
111111111
