R	1920	1080

S	../../sprites/pillar.xpm

NO	../../sprites/eagle.xpm
SO	../../sprites/colorstone.xpm
WE	../../sprites/greystone.xpm
EA	../../sprites/purplestone.xpm

F	101  , 102, 103
C	201   ,		 	   0 , 201

11111111111
1002000N001
10000000111
11111111111
