R	8000 8000

NO	srcs/sprites/mossy.xpm
SO	srcs/sprites/colorstone.xpm
WE	srcs/sprites/greystone.xpm
EA	srcs/sprites/redbrick.xpm
S	srcs/sprites/cara.xpm

F	65, 43, 40
C	151, 0, 201

11111111111111
10000000002001
10020000000001
10000000000001
10000000000001
10000000200001
10000000000001
10000000000001
10002000000001
10000111000001
10000110000001
10000111000001
10000000200001
10000000000001
10000000000001
100N0000002001
10000000000001
11111111111111
